x,x x,x x,x x,x x,x x,x x,x x,x x,x x,x x,x x,x x,x x,x x,x x,x x,x x,x x,x x,x x,x x,x x,x x,x x,x x,x x,x x,x x,x x,x x,x x,x x,x x,x x,x x,x x,x x,x x,x x,x x,x x,x x,x x,x x,x x,x x,x x,x x,x x,x
x,x x,x 0,1 x,x x,x x,x x,x x,x x,x x,x x,x x,x x,x x,x x,x x,x x,x x,x x,x x,x x,x x,x x,x x,x x,x x,x x,x x,x x,x x,x x,x x,x x,x x,x x,x x,x x,x x,x x,x x,x x,x x,x x,x x,x x,x x,x x,x x,x x,x x,x
x,x x,x 0,1 x,x x,x x,x x,x x,x x,x x,x x,x x,x x,x x,x x,x x,x x,x x,x x,x x,x x,x x,x x,x x,x x,x x,x x,x x,x x,x x,x x,x x,x x,x x,x x,x x,x x,x x,x x,x x,x x,x x,x x,x x,x x,x x,x x,x x,x x,x x,x
x,x x,x 0,1 x,x x,x x,x x,x x,x x,x x,x x,x x,x x,x x,x x,x x,x x,x x,x x,x x,x x,x x,x x,x x,x x,x x,x x,x x,x x,x x,x x,x x,x x,x x,x x,x x,x x,x x,x x,x x,x x,x x,x x,x x,x x,x x,x x,x x,x x,x x,x
x,x x,x 0,1 x,x x,x x,x x,x 0,1 x,x x,x x,x x,x 0,1 x,x x,x x,x x,x 0,1 x,x x,x x,x x,x 0,1 x,x x,x x,x x,x 0,1 x,x x,x x,x x,x 0,1 x,x x,x x,x x,x 0,1 x,x x,x x,x x,x 0,1 x,x x,x x,x x,x 0,1 x,x x,x
x,x x,x 0,1 x,x x,x x,x x,x 0,1 x,x x,x x,x x,x 0,1 x,x x,x x,x x,x 0,1 x,x x,x x,x x,x 0,1 x,x x,x x,x x,x 0,1 x,x x,x x,x x,x 0,1 x,x x,x x,x x,x 0,1 x,x x,x x,x x,x 0,1 x,x x,x x,x x,x 0,1 x,x x,x
x,x x,x 0,1 x,x x,x x,x x,x 0,1 x,x x,x x,x x,x 0,1 x,x x,x x,x x,x 0,1 x,x x,x x,x x,x 0,1 x,x x,x x,x x,x 0,1 x,x x,x x,x x,x 0,1 x,x x,x x,x x,x 0,1 x,x x,x x,x x,x 0,1 x,x x,x x,x x,x 0,1 x,x x,x
x,x x,x 0,1 x,x x,x x,x x,x 0,1 x,x x,x x,x x,x 0,1 x,x x,x x,x x,x 0,1 x,x x,x x,x x,x 0,1 x,x x,x x,x x,x 0,1 x,x x,x x,x x,x 0,1 x,x x,x x,x x,x 0,1 x,x x,x x,x x,x 0,1 x,x x,x x,x x,x 0,1 x,x x,x
x,x x,x 0,1 x,x x,x x,x x,x 0,1 x,x x,x x,x x,x 0,1 x,x x,x x,x x,x 0,1 x,x x,x x,x x,x 0,1 x,x x,x x,x x,x 0,1 x,x x,x x,x x,x 0,1 x,x x,x x,x x,x 0,1 x,x x,x x,x x,x 0,1 x,x x,x x,x x,x 0,1 x,x x,x
x,x x,x 0,1 x,x x,x x,x x,x 0,1 x,x x,x x,x x,x 0,1 x,x x,x x,x x,x 0,1 x,x x,x x,x x,x 0,1 x,x x,x x,x x,x 0,1 x,x x,x x,x x,x 0,1 x,x x,x x,x x,x 0,1 x,x x,x x,x x,x 0,1 x,x x,x x,x x,x 0,1 x,x x,x
x,x x,x 0,1 x,x x,x x,x x,x 0,1 x,x x,x x,x x,x 0,1 x,x x,x x,x x,x 0,1 x,x x,x x,x x,x 0,1 x,x x,x x,x x,x 0,1 x,x x,x x,x x,x 0,1 x,x x,x x,x x,x 0,1 x,x x,x x,x x,x 0,1 x,x x,x x,x x,x 0,1 x,x x,x
x,x x,x 0,1 x,x x,x x,x x,x 0,1 x,x x,x x,x x,x 0,1 x,x x,x x,x x,x 0,1 x,x x,x x,x x,x 0,1 x,x x,x x,x x,x 0,1 x,x x,x x,x x,x 0,1 x,x x,x x,x x,x 0,1 x,x x,x x,x x,x 0,1 x,x x,x x,x x,x 0,1 x,x x,x
x,x x,x 0,1 x,x x,x x,x x,x 0,1 x,x x,x x,x x,x 0,1 x,x x,x x,x x,x 0,1 x,x x,x x,x x,x 0,1 x,x x,x x,x x,x 0,1 x,x x,x x,x x,x 0,1 x,x x,x x,x x,x 0,1 x,x x,x x,x x,x 0,1 x,x x,x x,x x,x 0,1 x,x x,x
x,x x,x 0,1 x,x x,x x,x x,x 0,1 x,x x,x x,x x,x 0,1 x,x x,x x,x x,x 0,1 x,x x,x x,x x,x 0,1 x,x x,x x,x x,x 0,1 x,x x,x x,x x,x 0,1 x,x x,x x,x x,x 0,1 x,x x,x x,x x,x 0,1 x,x x,x x,x x,x 0,1 x,x x,x
x,x x,x 0,1 x,x x,x x,x x,x 0,1 x,x x,x x,x x,x 0,1 x,x x,x x,x x,x 0,1 x,x x,x x,x x,x 0,1 x,x x,x x,x x,x 0,1 x,x x,x x,x x,x 0,1 x,x x,x x,x x,x 0,1 x,x x,x x,x x,x 0,1 x,x x,x x,x x,x 0,1 x,x x,x
x,x x,x 0,1 x,x x,x x,x x,x 0,1 x,x x,x x,x x,x 0,1 x,x x,x x,x x,x 0,1 x,x x,x x,x x,x 0,1 x,x x,x x,x x,x 0,1 x,x x,x x,x x,x 0,1 x,x x,x x,x x,x 0,1 x,x x,x x,x x,x 0,1 x,x x,x x,x x,x 0,1 x,x x,x
x,x x,x 0,1 x,x x,x x,x x,x 0,1 x,x x,x x,x x,x 0,1 x,x x,x x,x x,x 0,1 x,x x,x x,x x,x 0,1 x,x x,x x,x x,x 0,1 x,x x,x x,x x,x 0,1 x,x x,x x,x x,x 0,1 x,x x,x x,x x,x 0,1 x,x x,x x,x x,x 0,1 x,x x,x
x,x x,x 0,1 x,x x,x x,x x,x 0,1 x,x x,x x,x x,x 0,1 x,x x,x x,x x,x 0,1 x,x x,x x,x x,x 0,1 x,x x,x x,x x,x 0,1 x,x x,x x,x x,x 0,1 x,x x,x x,x x,x 0,1 x,x x,x x,x x,x 0,1 x,x x,x x,x x,x 0,1 x,x x,x
x,x x,x 0,1 x,x x,x x,x x,x 0,1 x,x x,x x,x x,x 0,1 x,x x,x x,x x,x 0,1 x,x x,x x,x x,x 0,1 x,x x,x x,x x,x 0,1 x,x x,x x,x x,x 0,1 x,x x,x x,x x,x 0,1 x,x x,x x,x x,x 0,1 x,x x,x x,x x,x 0,1 x,x x,x
x,x x,x 0,1 x,x x,x x,x x,x 0,1 x,x x,x x,x x,x 0,1 x,x x,x x,x x,x 0,1 x,x x,x x,x x,x 0,1 x,x x,x x,x x,x 0,1 x,x x,x x,x x,x 0,1 x,x x,x x,x x,x 0,1 x,x x,x x,x x,x 0,1 x,x x,x x,x x,x 0,1 x,x x,x