5,9 5,9 5,9 5,9 5,9 5,9 5,9 5,9 5,9 5,9 5,9 5,9 5,9 5,9 5,9 5,9 5,9 5,9 5,9 5,9 5,9 5,9 5,9 5,9 5,9 5,9 5,9 5,9 5,9 5,9 5,9 5,9 5,9 5,9 5,9 5,9 5,9 5,9 5,9 5,9 5,9 5,9 5,9 5,9 5,9 5,9 5,9 5,9 5,9 5,9
5,9 4,8 4,8 4,8 4,8 4,8 4,8 4,8 4,8 4,8 4,8 4,8 4,8 4,8 4,8 4,8 4,8 4,8 4,8 4,8 4,8 4,8 4,8 4,8 4,8 4,8 4,8 4,8 4,8 4,8 4,8 4,8 4,8 4,8 4,8 4,8 4,8 4,8 4,8 4,8 4,8 4,8 4,8 4,8 4,8 4,8 4,8 4,8 4,8 5,9
5,9 4,8 4,8 4,8 4,8 4,8 4,8 4,8 4,8 4,8 4,8 4,8 4,8 4,8 4,8 4,8 4,8 4,8 4,8 4,8 4,8 4,8 4,8 4,8 4,8 4,8 4,8 4,8 4,8 4,8 4,8 4,8 4,8 4,8 4,8 4,8 4,8 4,8 4,8 4,8 4,8 4,8 4,8 4,8 4,8 4,8 4,8 4,8 4,8 5,9
5,9 4,8 4,8 4,8 4,8 4,8 4,8 4,8 4,8 4,8 4,8 4,8 4,8 4,8 4,8 4,8 4,8 4,8 4,8 4,8 4,8 4,8 4,8 4,8 4,8 4,8 4,8 4,8 4,8 4,8 4,8 4,8 4,8 4,8 4,8 4,8 4,8 4,8 4,8 4,8 4,8 4,8 4,8 4,8 4,8 4,8 4,8 4,8 4,8 5,9
5,9 4,8 4,8 4,8 4,8 4,8 4,8 4,8 4,8 4,8 4,8 4,8 4,8 4,8 5,6 5,6 4,8 4,8 4,8 4,8 4,8 5,9 5,9 5,9 5,9 5,9 5,9 5,9 5,9 -1#8 5,9 5,9 5,9 5,9 -1#8 -1#8 5,9 5,9 5,9 5,9 4,8 4,8 4,8 4,8 4,8 4,8 4,8 4,8 4,8 5,9
5,9 5,9 5,9 5,9 4,8 4,8 4,8 4,8 4,8 4,8 4,8 4,8 4,8 5,6 5,6 4,8 4,8 4,8 4,8 4,8 4,8 4,8 4,8 4,8 4,8 4,8 -1#8 -1#8 -1#8 -1#8 -1#8 -1#8 -1#8 -1#8 -1#8 -1#8 -1#8 -1#8 4,8 4,8 4,8 4,8 4,8 4,8 4,8 4,8 4,8 4,8 4,8 5,9
5,9 4,8 4,8 4,8 4,8 4,8 4,8 4,8 5,9 5,9 5,9 5,9 5,9 5,9 5,9 4,8 4,8 4,8 4,8 4,8 4,8 4,8 4,8 4,8 4,8 4,8 -1#8 -1#8 -1#8 -1#8 -1#8 -1#8 -1#8 -1#8 -1#8 -1#8 -1#8 -1#8 4,8 4,8 4,8 4,8 4,8 5,6 5,6 5,6 5,6 4,8 4,8 5,9
5,9 4,8 4,8 4,8 4,8 4,8 4,8 4,8 5,9 4,8 4,8 4,8 4,8 4,8 4,8 4,8 4,8 4,8 4,8 4,8 4,8 4,8 4,8 4,8 4,8 4,8 -1#8 -1#8 -1#8 -1#8 -1#8 -1#8 -1#8 -1#8 -1#8 -1#8 -1#8 -1#8 4,8 4,8 4,8 4,8 4,8 4,8 4,8 4,8 4,8 4,8 4,8 5,9
5,9 4,8 4,8 4,8 4,8 4,8 4,8 4,8 5,9 4,8 4,8 4,8 4,8 4,8 4,8 4,8 4,8 4,8 4,8 4,8 4,8 4,8 4,8 4,8 4,8 4,8 5,9 5,9 5,9 5,9 5,9 5,9 5,9 5,9 5,9 5,9 5,9 5,9 4,8 4,8 4,8 4,8 4,8 4,8 4,8 4,8 4,8 4,8 4,8 5,9
5,9 4,8 4,8 4,8 4,8 4,8 4,8 4,8 5,9 4,8 4,8 4,8 4,8 4,8 4,8 4,8 4,8 4,8 4,8 4,8 4,8 4,8 4,8 4,8 4,8 5,9 5,9 4,8 4,8 4,8 4,8 4,8 4,8 4,8 4,8 4,8 4,8 4,8 4,8 4,8 4,8 4,8 5,9 4,8 4,8 4,8 4,8 4,8 4,8 5,9
5,9 4,8 4,8 4,8 4,8 4,8 4,8 4,8 5,9 4,8 4,8 4,8 4,8 4,8 4,8 4,8 4,8 4,8 4,8 4,8 4,8 4,8 4,8 4,8 5,9 5,9 4,8 4,8 4,8 4,8 4,8 4,8 4,8 4,8 4,8 4,8 4,8 4,8 4,8 4,8 4,8 4,8 5,9 4,8 4,8 4,8 4,8 4,8 4,8 5,9
5,9 4,8 4,8 4,8 4,8 4,8 4,8 4,8 5,9 4,8 4,8 4,8 4,8 4,8 4,8 4,8 4,8 4,8 4,8 4,8 4,8 4,8 4,8 5,9 5,9 4,8 4,8 4,8 4,8 4,8 5#6 5#6 5,6 5,6 5,6 5,6 4,8 4,8 4,8 4,8 4,8 4,8 5,9 4,8 4,8 4,8 4,8 4,8 4,8 5,9
5,9 5,9 5,9 5,9 4,8 4,8 4,8 4,8 4,8 4,8 4,8 4,8 4,8 4,8 5,9 5,9 5,9 5,9 5,9 5,9 5,9 5,9 5,9 5,9 4,8 4,8 4,8 4,8 4,8 5,6 5,6 5,6 5,6 5#6 4,8 4,8 4,8 4,8 4,8 4,8 4,8 4,8 5,9 4,8 4,8 4,8 4,8 5,6 5,6 5,9
5,9 4,8 4,8 4,8 4,8 4,8 4,8 4,8 4,8 4,8 4,8 4,8 4,8 5,9 5,9 4,8 4,8 4,8 4,8 4,8 4,8 4,8 4,8 4,8 4,8 4,8 4,8 4,8 4,8 4,8 4,8 4,8 4,8 4,8 4,8 4,8 4,8 4,8 4,8 4,8 4,8 4,8 5,9 4,8 4,8 4,8 4,8 4,8 4,8 5,9
5,9 4,8 4,8 4,8 4,8 4,8 4,8 4,8 4,8 4,8 4,8 4,8 4,8 5,9 4,8 4,8 4,8 4,8 4,8 4,8 4,8 4,8 4,8 4,8 4,8 4,8 4,8 4,8 4,8 4,8 4,8 4,8 4,8 4,8 4,8 4,8 4,8 5,9 5,9 5,9 5,9 5,9 5,9 4,8 4,8 4,8 4,8 4,8 4,8 5,9
5,9 4,8 4,8 4,8 4,8 4,8 4,8 4,8 4,8 4,8 4,8 4,8 4,8 5,9 4,8 4,8 4,8 4,8 4,8 4,8 4,8 4,8 4,8 4,8 4,8 4,8 4,8 4,8 4,8 4,8 4,8 4,8 4,8 4,8 4,8 4,8 4,8 4,8 4,8 4,8 4,8 4,8 4,8 4,8 4,8 4,8 4,8 4,8 4,8 5,9
5,9 -1#8 -1#8 -1#8 -1#8 -1#8 -1#8 5,9 5,9 5,9 5,9 5,9 5,9 5,9 4,8 4,8 4,8 4,8 4,8 4,8 4,8 4,8 4,8 4,8 4,8 4,8 4,8 4,8 4,8 4,8 5,9 5,9 5,9 5,9 5,9 5,9 5,9 4,8 4,8 4,8 4,8 4,8 4,8 4,8 4,8 4,8 4,8 5,6 5,6 5,9
5,9 4,8 4,8 4,8 4,8 4,8 4,8 4,8 4,8 4,8 4,8 4,8 4,8 4,8 4,8 4,8 4,8 4,8 4,8 4,8 4,8 4,8 4,8 4,8 4,8 4,8 4,8 4,8 4,8 4,8 4,8 4,8 4,8 4,8 4,8 4,8 4,8 4,8 4,8 4,8 4,8 4,8 4,8 4,8 4,8 4,8 4,8 4,8 4,8 5,9
5,9 4,8 4,8 4,8 4,8 4,8 4,8 4,8 4,8 4,8 4,8 4,8 4,8 4,8 4,8 4,8 4,8 4,8 4,8 4,8 4,8 4,8 4,8 4,8 4,8 4,8 4,8 4,8 4,8 4,8 4,8 4,8 4,8 4,8 4,8 4,8 4,8 4,8 4,8 4,8 4,8 4,8 4,8 4,8 4,8 4,8 4,8 4,8 4,8 5,9
5,9 5,9 5,9 5,9 5,9 5,9 5,9 5,9 5,9 5,9 5,9 5,9 5,9 5,9 5,9 5,9 5,9 5,9 5,9 5,9 5,9 5,9 5,9 5,9 5,9 5,9 5,9 5,9 5,9 5,9 5,9 5,9 5,9 5,9 5,9 5,9 5,9 5,9 5,9 5,9 5,9 5,9 5,9 5,9 5,9 5,9 5,9 5,9 5,9 5,9
