11,13 11,13 11,13 11,13 11,11 11,11 10,11 11,11 11,11 11,11 11,11 11,11 11,11 11,11 11,11 11,11 11,11 11,11 11,11 11,11 11,11 11,11 11,11 11,11 11,11 11,11 11,11 11,11 11,11 11,11 11,11 11,11 11,11 11,11 11,11 11,11 11,11 11,11 11,11 11,11 11,11 11,11 11,11 11,11 11,11 11,11 11,11 11,11 11,11 11,11
11,10 11,13 11,13 11,13 11,13 11,13 11,13 11,13 11,13 11,13 11,13 11,13 11,13 11,13 11,13 11,13 11,13 11,13 11,13 11,13 11,13 11,13 11,13 11,13 11,13 11,13 11,13 11,13 11,13 11,13 11,13 11,13 11,13 11,13 11,13 11,13 11,13 11,13 11,13 11,13 11,13 11,13 11,13 11,13 11,13 11,13 11,13 11,13 11,13 11,11
11,11 11,13 11,13 11,13 11,13 11,13 11,13 11,13 11,13 11,13 11,13 11,13 11,13 11,13 11,13 11,13 11,13 11,13 11,13 11,13 11,13 11,13 11,13 11,13 11,13 11,13 11,13 11,13 11,13 11,13 11,13 11,13 11,13 11,13 11,13 11,13 11,13 11,13 11,13 11,13 11,13 11,13 11,13 11,13 11,13 11,13 11,13 11,13 11,13 11,11
11,11 11,13 11,13 11,13 11,13 11,13 11,13 11,13 11,13 11,13 11,13 11,13 11,13 11,13 11,13 11,13 11,13 11,13 11,13 11,13 11,13 11,13 11,13 11,13 11,13 11,13 11,13 11,13 11,13 11,13 11,13 11,13 11,13 11,13 11,13 11,13 11,13 11,13 11,13 11,13 11,13 11,13 11,13 11,13 11,13 11,13 11,13 11,13 11,13 11,11
11,11 11,13 11,13 11,13 11,13 11,13 11,13 11,13 11,13 11,13 11,13 11,13 11,13 11,13 11,13 11,13 11,13 11,13 11,13 11,13 11,13 11,13 11,13 11,13 11,13 11,13 11,13 11,13 11,13 11,13 11,13 11,13 11,13 11,13 11,13 11,13 11,13 11,13 11,13 11,13 11,13 11,13 11,13 11,13 11,13 11,13 11,13 11,13 11,13 11,11
11,11 11,13 11,13 11,13 11,13 11,13 11,13 11,13 11,13 11,13 11,13 11,13 11,13 11,13 11,13 11,13 11,13 11,13 11,13 11,13 11,13 11,13 11,13 11,13 11,13 11,13 11,13 11,13 11,13 11,13 11,13 11,13 11,13 11,13 11,13 11,13 11,13 11,13 11,13 11,13 11,13 11,13 11,13 11,13 11,13 11,13 11,13 11,13 11,13 11,11
11,11 11,13 11,13 11,13 11,13 11,13 11,13 11,13 11,13 11,13 11,13 11,13 11,13 11,13 11,13 11,13 11,13 11,10 11,10 11,10 11,10 11,13 11,13 11,13 11,13 11,13 11,13 11,13 11,13 11,13 11,13 11,13 11,13 11,13 11,13 11,13 11,13 11,13 11,13 11,13 11,13 11,13 11,13 11,13 11,13 11,13 11,13 11,13 11,13 11,11
11,11 11,13 11,13 11,13 11,13 11,13 11,13 11,13 11,13 11,13 11,13 11,13 11,13 11,13 11,13 11,13 11,13 11,13 11,13 11,13 11,13 11,13 11,13 11,13 11,13 11,13 11,13 11,13 11,13 11,13 11,13 11,13 11,13 11,13 11,13 11,13 11,13 11,13 11,13 11,13 11,13 11,13 11,13 11,13 11,13 11,13 11,13 11,13 11,13 11,11
11,11 11,13 11,13 11,13 11,13 11,13 11,13 11,10 11,13 11,13 11,13 11,13 11,13 11,13 11,13 11,13 11,13 11,13 11,13 11,13 11,13 11,13 11,13 11,13 11,13 11,13 11,13 11,13 11,13 11,13 11,13 11,13 11,13 11,13 11,13 11,13 11,13 11,13 11,13 11,13 11,13 11,13 11,13 11,13 11,13 11,13 11,13 11,13 11,13 11,11
11,11 11,13 11,13 11,13 11,13 11,13 11,13 11,11 11,13 11,13 11,13 11,13 11,10 11,10 11,10 11,13 11,13 11,13 11,13 11,13 11,10 11,13 11,13 11,13 11,10 11,13 11,13 11,13 11,13 11,13 11,13 11,13 11,13 11,13 11,13 11,13 11,13 11,13 11,13 11,13 11,13 11,13 11,13 11,13 11,13 11,13 11,13 11,13 11,13 11,11
11,11 11,13 11,13 11,13 11,13 11,13 11,13 11,11 11,13 11,13 11,13 11,13 11,13 11,13 11,11 11,13 11,13 11,13 11,13 11,13 11,11 11,13 11,13 11,13 11,11 11,13 11,13 11,13 11,13 11,13 11,13 11,13 11,13 11,13 11,13 11,13 11,13 11,13 11,13 11,13 11,13 11,13 11,13 11,13 11,13 11,13 11,13 11,13 11,13 11,11
11,11 11,13 11,13 11,13 11,13 11,13 11,13 11,11 11,13 11,13 11,13 11,13 11,13 11,13 11,11 11,13 11,13 11,13 11,13 11,13 11,11 11,13 11,13 11,13 11,11 11,13 11,13 11,13 11,13 11,13 11,13 11,13 11,13 11,13 11,13 11,13 11,13 11,13 11,13 11,13 11,13 11,13 11,13 11,13 11,13 11,13 11,13 11,13 11,13 11,11
11,11 11,13 11,13 11,13 11,13 11,13 11,13 11,11 11,13 11,13 11,13 11,13 11,13 11,13 11,11 11,13 11,13 11,13 11,13 11,13 11,11 11,13 11,13 11,13 11,11 11,13 11,13 11,13 11,13 11,13 11,13 11,13 11,13 11,13 11,13 11,13 11,13 11,13 11,13 11,13 11,13 11,13 11,13 11,13 11,13 11,13 11,13 11,13 11,13 11,11
11,11 11,13 11,13 11,13 11,13 11,13 11,13 11,11 11,10 11,10 11,10 11,13 11,13 11,13 11,11 11,13 11,13 11,13 11,13 11,13 11,11 11,13 11,13 11,13 11,11 11,13 11,13 11,13 11,13 11,13 11,13 11,13 11,13 11,13 11,13 11,13 11,13 11,13 11,13 11,13 11,13 11,13 11,13 11,13 11,13 11,13 11,13 11,13 11,13 11,11
11,11 11,13 11,13 11,13 11,13 11,13 11,13 11,13 11,13 11,13 11,13 11,13 11,13 11,13 11,11 11,13 11,13 11,13 11,13 11,12 11,11 11,13 11,13 11,13 11,11 11,10 11,10 11,10 11,10 11,10 11,10 11,13 11,13 11,13 11,13 11,13 11,13 11,13 11,13 11,13 11,13 11,13 11,13 11,13 11,13 11,13 11,13 11,13 11,13 11,11
11,11 11,13 11,13 11,13 11,13 11,13 11,13 11,13 11,13 11,13 11,13 11,13 11,13 11,13 11,11 11,13 11,13 11,13 11,13 11,13 11,11 11,13 11,13 11,13 11,11 0,0 0,0 0,0 0,0 0,0 0,0 11,10 11,13 11,13 11,13 11,13 11,13 11,13 11,13 11,13 11,13 11,13 11,13 11,13 11,13 11,13 11,13 11,13 11,13 11,11
11,11 11,13 11,13 11,13 11,13 11,13 11,13 11,13 11,13 11,13 11,13 11,13 11,13 11,13 11,11 11,13 11,13 11,13 11,13 11,13 11,11 11,13 11,13 11,13 11,11 0,0 0,0 0,0 0,0 0,0 0,0 0,0 11,10 11,13 11,13 11,13 11,13 11,13 11,13 11,13 11,13 11,13 11,13 11,13 11,13 11,13 11,13 11,13 11,13 11,11
11,11 11,13 11,13 11,13 11,13 11,13 11,13 11,13 11,13 11,13 11,13 11,13 11,13 11,13 11,13 11,13 11,13 11,13 11,13 11,13 11,13 11,13 11,13 11,13 11,11 0,0 0,0 0,0 0,0 0,0 0,0 0,0 0,0 11,10 11,10 11,10 11,10 11,10 11,10 11,10 11,10 11,10 11,10 11,10 11,10 11,10 11,10 11,10 11,10 11,10
11,11 11,13 11,13 11,13 11,13 11,13 11,13 11,13 11,13 11,13 11,13 11,13 11,13 11,13 11,13 11,13 11,13 11,13 11,13 11,13 11,13 11,13 11,13 11,13 11,11 0,0 0,0 0,0 0,0 0,0 0,0 0,0 0,0 0,0 0,0 0,0 0,0 0,0 0,0 0,0 0,0 0,0 0,0 0,0 0,0 0,0 0,0 1,-1 0,0 11,11
11,11 11,10 11,10 11,10 11,10 11,10 11,10 11,10 11,10 11,10 11,10 11,10 11,10 11,10 11,10 11,10 11,10 11,10 11,10 11,10 11,10 11,10 11,10 11,10 11,11 0,0 0,0 0,0 0,0 0,0 0,0 0,0 0,0 0,0 0,0 0,0 0,0 0,0 0,0 0,0 0,0 0,0 0,0 0,0 0,0 0,0 0,0 0,0 0,0 11,11
